WE    ./textures/south.xpm
EA ./textures/east.xpm
S ./textures/barrel.xpm
F 100,  80,     255
NO ./textures/west.xpm
    SO ./textures/north.xpm
C 255 ,  0 ,      0
R    1920    1080

11111111111111111111111111
10000010100010101010010011
10020010100000201010010001
10000020100000100010010001
100S0000100000101010010011
10100010100010101210010001
10100010100010101010010011
10100010100010101210010001
10020010100000201010010001
10000020100000100010010001
10102010100010101010010001
10000010100010101010010011
11111111111111111111111111